NO                 ./map.cub
SO                                                       ./map.cub

EA ./map.cub

F 220,100,0













C 225,30,0
WE ./map.cub


        1
        1111111111111111111111111
        1000000000110000000000001
1       1011000001110000000000001
      1  1001000000000000000000001
111111111011000001110000000000001
100000000011000001110111111111111
11110111111111011100000010001
11110111111111011101010010001
11000000110101011100000010001
10000000000000001100000010001
100000000000000011010100101001
110000011101010111110110110N1111
11110111 11101011101111010001
11111111 1111111 111111111111
